R 852 480
NO ./textures/brick.xpm42
SO ./textures/metal.xpm42
WE ./textures/brick.xpm42
EA ./textures/stone.xpm42
S ./textures/grass.xpm42
F   120, 120, 120

1111
1001
1N01
1111
