R 852 480
NO ./textures/brick.xpm
SO ./textures/metal.xpm
WE ./textures/brick.xpm
EA ./textures/stone.xpm
S ./textures/grass.xpm
F   120, 120, 120
C   135, 206, 235

1111111111111111111
        1000000000111111111111111
        1000000001100000000000001
        1011000001110000002000001
        1001000000000000000000001
111111111011000001110000000000001
100000000011000001110111111111111
11110111111111011100000010001
11110111111111011101010010001
11000000110101011100000010001
10002000000000001100000010001
10000000000000001101010000001
11000001110101011111011110W0111
11110111 1110101 101111010001
11111111 1111111 111111111111
