R 852 852
NO ./textures/red_bricks.bmp
SO ./textures/bricks.bmp
WE ./textures/wood.bmp
EA ./textures/concrete.bmp
S ./textures/sprite.bmp
F   120, 120, 120
C   135, 206, 235

11111111111
10000000001
10020002001
10000N00001
10020002001
10000000001
11111111111
