R 852 480
NO ./textures/red_bricks.bmp
SO ./textures/bricks.bmp
WE ./textures/wood.bmp
EA ./textures/concrete.bmp
S ./textures/sprite.bmp
F   220, 100,0
C    225,   30  ,0

11111111111
10000000001
10020002001
10000N00001
10020002001
10000000001
11111111111
