R 852 480
NO ./textures/brick.xpm
SO ./textures/metal.xpm
WE ./textures/brick.xpm
EA ./textures/stone.xpm
S ./textures/sprite.xpm
F   120, 120, 120
C   135, 206, 235

       1111111
       100S001
       1000001
       1020201
       1000001
       1000001
       1020201
111111110000011111111
100000000020000000001
100000000000000000001
100200200202002002001
100000000000000000001
100000000020000000001
111111110000011111111
       1020201
       1000001
       1000001
       1020201
       1000001
       1000001
       1111111
