R 1920 1920
NO ./textures/brick.xpm42
SO ./textures/metal.xpm42
WE ./textures/brick.xpm42
EA ./textures/stone.xpm42
S ./textures/sprite.xpm42
F   120, 120, 120
C   135, 206, 235

111111111
100000001
100020001
100000001
100000001
100000001
100020001
100000001
100000001
1000N0001
100000001
100020001
100000001
100020001
100000001
100020001
100000001
111111111
